-#-------#-----#-----#-----#---####---#-
-#-#####-#-###---###-#-###-#-#----#-#-#-
-#--##---#----###----#---#---#-####-#---
--#-#--######-#---######-#-#-#---#--####
#---#-##--------###--------#-###-#-####-
###-#----###-####-#--###---#-#---#------
----######-----------#---#####-#-###-###
-###---#---###########-###-----#-----#--
-----#---#--#----------#######-#-###-#--
###########-#-###------------------#-#--
------------#---#---##########-###------
##-####-#######-###-##-----------#####-#
-#-#--#-#-----------##-###-#####-----#-#
-#-#----#-####-##-####--#------####-##-#
-#-######-####-#--#---#-#-####--#----#-#
-------------#-#----#---#-#--####-####--
####-#######-#-######-###-#-#-----------
-----#------------------#-----#-#######-
##-###-##########-#####-#-#####-#-#---#-
---#---#--------#-#---------#-----#-#-#-
-#-###-###-####-#-#-#######-####-##-#-#-
-#-------#---#--#-#-#----------#----#-#-
##-###-#---#-#-##-#-##-##-####-#--###-#-
---#---#####------#----#-------#--#-----
-###-#----------#-####-#####-###-###-###
-#-#-##########-#-----------------------
-#-----#--------#-#######-#####-####-###
-#####-#-##-#####----#--#--#-------#----
-------------------#-##-##-############-
###-##############-#-------#------------
#-#--------------#-#########---#-#--####
#-#-#####-#------#-#-------#-#-#-#--#---
#---#-----#-######-#######-#-#-###-##-#-
######-####----#---#-----#-#-#------#-#-
-#--------####-#-#-#-##-##-#-###-####-#-
-#--##-##----#-#-#-#--#----#---#------#-
-#-#########-#-#-####-#-##-#-#-#####--#-
-#-#-----------#-#----#-#--#-#-----#--#-
-#-#-###-#####-#-#-####-##########-#--#-
-----#-------#-#------#-----------------